coronavirus,covid,COVID-19,maladie à coronavirus 2019,SRAS-CoV-2,2019-nCoV,novel coronavirus,nouveau coronavirus

ACIA => ACIA, Agence canadienne des inspections des aliments
ARM => ARM, Agent des relations avec les médias
ASPC => ASPC, Agence de santé publique du Canada
BESC => BESC, Bureau de l'expert scientifique en chef
BVR => BVR, Bureau de la vérification et de la responsabilisation
CEPMB => CEPMB, Conseil d'examen des prix des médicaments brevetés
CCRMD => CCRMD, Conseil de contrôle des renseignements relatifs aux matières dangereuses
DCMC => DCMC, Direction de communications, du marketing et de la consultation
DGSPNI => DGSPNI, Direction générale de la santé des Premières nations et des Inuits
DGPSA => DGPSA, Direction générale des produits de santé et des aliments
DGPSC => DGPSC, Direction générale de la politique de la santé et des consultations
DGSESC => DGSESC, Direction générale de la santé environnementale et de la sécurité des consommateurs
DGSG => DGSG, Direction générale des services de gestion
FAQ => FAQ, Foire aux questions
GED => GED, Gouvernement en direct
HTML => HTML, Langage hypertexte (Hypertext Markup Language)
IRSC => IRSC, Instituts de recherche en santé du Canada
NSI => NSI, Normalisation des sites Internet
PCIM => PCIM, Programme de coordination de l' image de marque
PCS => PCS, Le portail canadien sur la santé
PDF => PDF, Format de document portable (Portable Document Format)
PPT => PPT, PowerPoint
RCS => RCS, Réseau canadien de la santé
RTF => RTF, Rich Text Format
SCD => SCD, Santé Canada en direct
SCT => SCT, Secrétariat du Conseil du Trésor
S et C => S et C, Subventions et contributions
SM => SM, Sous-ministre
SMD => SMD, Sous-ministre déléguée
URL => URL, Adresse URL


a.-c. => a.-c., Assurance-chômage
a.-e. => a.-e., Assurance-emploi
Appli-Web => Appli-Web, Demande d'assurance-emploi en-ligne
ARC => ARC, Agence du revenu du Canada
BACE => BACE, Bureau de l'alphabétisation et des compétences essentielles
BSIF => BSIF, Bureau du surintendant des institutions financières
BVG => BVG, Bureau du vérificateur général du Canada
CAEC => CAEC, Commission de l'assurance-emploi du Canada
Cégep => Cégep, Collège d'enseignement général et professionnel
CNP => CNP, Classification nationale des professions
CSC => CSC, Centre Service Canada
CSE => CSE, Centre de services aux employeurs
CV => CV, Coefficient de variation
DC => DC, Développement des compétences
DC-A => DC-A, Volet apprentis du Développement des compétences
DC-R => DC-R, Volet régulier du Développement des compétences
DEREMPA => DEREMPA, Personnes qui deviennent ou redeviennent membres de la population active
DPP => DPP, Début de la période de la prestation
ECAE => ECAE, Enquête sur la couverture de l'assurance-emploi
ECPIE => ECPIE, Enquête canadienne par panel sur l'interruption d'emploi
EDMT => EDMT, Entente sur le développement du marché du travail
EDSC => EDSC, Emploi et Développement social Canada
EDTR => EDTR, Enquête sur la dynamique du travail et du revenu
EERH => EERH, Enquête sur l'emploi, la rémunération et les heures de travail
EPA => EPA, Enquête sur la population active
É-U => É-U, États-Unis (d'Amérique)
G7 => G7, Groupe des sept pays
IMT => IMT, Information sur le marché du travail
MDSC => MDSC, Mon dossier Service Canada
MRA => MRA, Maximum de la rémunération assurable
MSV => MSV, Meilleures semaines variables
NVA => NVA, Norme variable d'admissibilité
OCDE => OCDE, Organisation de coopération et de développement économiques
PAIS => PAIS, Programme d'appui aux initiatives sectorielles
P/C => P/C, Prestations-cotisations
P/CC => P/CC, Prestataires/chômeurs ayant cotisé à l’assurance-emploi
PCE => PCE, Partenariats pour la création d'emplois
PEGM => PEGM, Prestation pour parents d'enfants gravement malades
PEMS => PEMS, Prestation d'emploi et mesures de soutien
PFE => PFE, Personnes formées à l'étranger
PFCE => PFCE, Prestation fiscale canadienne pour enfants
PIB => PIB, Produit intérieur brut
PMT => PMT, Partenariats du marché du travail
PNAQ => PNAQ, Programme national d'assurance de la qualité
PNEQ => PNEQ, Programme national d'encadrement et de la qualité
PRTC => PRTC, Programme de réduction du taux de cotisations
PSC => PSC, Prestations supplémentaires de chômage
PTET => PTET, Programme des travailleurs étrangers temporaires
RCÉ de l'a.-e. => RCÉ de l'a.-e., Rapport de contrôle et d'évaluation de l'assurance-emploi
RE => RE, Relevé d'emploi
RE Web => RE Web, Relevé d'emploi sur le Web
RHDCC => RHDCC, Ressources humaines et Développement des compétences Canada
RHDSC => RHDSC, Ressources humaines et Développement social Canada
RHM => RHM, Rémunération hebdomadaire moyenne
R et I => R et I, Recherche et Innovation
RPC => RPC, Régime de pensions du Canada
RQAP => RQAP, Régime québécois d'assurance parentale
RRR => RRR, Repérage, référence et rétroaction
RTCE => RTCE, Reconnaissance des titres de compétences
SAAE => SAAE, Système amélioré d'alerte-emploi
SAE => SAE, Services d'aide à l'emploi
SCIAN => SCIAN, Système de classification des industries de l'Amérique du Nord
SEJ => SEJ, Stratégie emploi jeunesse
SFCEA => SFCEA, Stratégie de formation pour les compétences et l'emploi destinée aux Autochtones
SIP => SIP, Séance d'information à l'intention des prestataires
SIPAE => SIPAE, Système d'information sur les prestations d'assurance-emploi
SNE => SNE, Services nationaux d'enquête
SNP => SNP, Service national de placement
SRC => SRC, Suppléments de rémunération ciblés
SRSA => SRSA, Société de recherche sociale appliquée
SSC => SSC, Subventions salariales ciblées
SV => SV, Sécurité de la vieillesse
T4E => T4E, Feuillet de renseignements fiscaux
TaC => TaC, Travailler au Canada
TAD => TAD, Traitement automatisé des demandes
TAP => TAP, Transfert automatisé protégé (des relevés d'emploi)
TPPP => TPPP, Travail pendant une période de prestations
TSS => TSS, Tribunal de la sécurité sociale
VEP => VEP, Vérification de l'exactitude des paiements
VET => VET, Vérification de l'exactitude du traitement
WCS => WCS, Western Canada Select
